23,16,16,16,16,16,16,16,16,16,21
18,15,8,8,8,8,8,8,8,13,17
18,10,1,1,1,1,1,1,1,9,17
18,10,1,1,1,1,1,1,1,9,17
18,10,1,1,1,1,1,1,1,9,17
18,10,1,1,1,1,1,1,1,9,17
18,10,1,1,1,1,1,1,1,9,17
18,10,1,1,1,1,1,1,1,9,17
18,10,1,1,1,1,1,1,1,9,17
18,14,11,11,11,11,11,11,11,12,17
22,19,19,19,19,19,19,19,19,19,20
